=== опред≈ления ===
iso646	макросы для символов &|~!^
stdbool	(c99)bool, true, false, __bool_true_false_are_defined
stddef	NULL, size_t, ptrdiff_t, offsetof(struct,member), (c++11): nullptr_t
limits	лимиты целых чисел и символов
stdint	(c99)целые числа: типы и лимиты (в т.ч. для stddef)
inttypes (с99)соответствие целых типов printf/scanf, abs, div, strtol, strtoul, wcstol, wcstoul
=== системное ===
assert	assert
errno	errno - последня ошибка, EDOM, ERANGE, EILSEQ
		+strerror from <string.h> + perror from <stdio.h>
setjmp	прыжки между функциями
signal	сигналы
stdarg	,...)
=== строки/символы ===
locale	setlocale(category, locale); struct lconv * localeconv()
ctype	типы символов is*****(ch), to****(ch)
wctype	WEOF, типы wide символов isw*****(ch), tow****(ch), и тоже по строке
string	NULL, size_t, операции со строками
=== общее ===
stdlib	строки в числа, 
	random, память; exit(), getenv(), system();
	bsearch(), qsort(); abs(), div(); 
	mblen(), mb[s]<->wc[s]
uchar	(c11)mb <-> c(16|32)
stdio	EOF, FILE, fpos_t, BUFSIZ, файлы, [v] ([f|s] (printf|scanf) | snprintf), [f] (get|put)(c|s) | (get|put)char, ошибки в файлах
time	время
wchar	(c99)fwide(), f(get|put)w(c|s) | (get|put)w(c|char), [v] [f|s]w(printf|scanf), строки в числа, строковые операции, время
=== floating ===
math	мат-ф-ции
tgmath	Type-generic math
float	плавающие числа: типы и лимиты
fenv	floating-point envinronment

